2 3 1 3 4
1 1 4 3 4
4 4 0 3 4
4 4 3 1 2
2 3 2 4 2