4 3 3 1 4
2 3 2 4 4
4 3 0 1 2
4 3 3 1 2
4 2 4 4 2