2 2 2 4 4
4 1 3 1 2
2 3 0 3 2
4 2 1 3 4
4 3 4 2 4