4 4 4 2 4
1 1 3 3 4
3 3 0 1 2
3 3 2 2 2
4 4 4 2 4