4 4 4 4 4
3 3 2 1 1
3 3 0 3 1
4 1 4 2 3
4 3 4 4 2
