2 4 2 1 2
3 2 3 4 4
1 3 0 3 2
4 4 2 3 4
4 1 2 2 4