4 3 3 1 2
4 2 3 2 4
4 2 0 2 4
2 3 2 1 2
4 3 4 4 2