4 4 3 1 4
2 2 3 1 2
2 3 0 2 1
3 4 4 4 1
2 1 2 4 2