4 4 4 3 4 4 4
2 3 3 3 3 2 1
2 4 2 4 3 2 1
2 3 3 0 2 3 3
4 2 4 3 4 1 4
4 4 4 3 2 3 4
2 3 3 2 4 2 4